111111111113333311111111111
100000000000313000000000001
101101111110010011111101101
100000000000010000000000001
111111110110111011011111111
100000000100000001000000001
101011101101111101111110101
101000100000000000001000101
101110101111000111101011101
100000000000000000000000001
111111102222333222201111101
000000002333333333200000000
101111102333333333201111111
100000002333333333200000001
101111102222222222201111101
101000000000010000000000101
101010111110010011111010101
100010000000111000000010001
101110111010010010111011101
100000001011010110100000001
111111101010010010101111111
100000000010111010000000001
101111011010010010110111101
100000001000010000100000001
111111111113333311111111111